{
    "level_number": 1,
    "moves": 30,
    "objectives": {
      "CHERRY": 10,
      "MAPLE": 10
    },
    "board": {
      "width": 8,
      "height": 8,
      "layout": [
        1, 1, 1, 1, 1, 1, 1, 1,
        1, 1, 1, 1, 1, 1, 1, 1,
        1, 1, 0, 0, 0, 0, 1, 1,
        1, 1, 0, 2, 2, 0, 1, 1,
        1, 1, 0, 2, 2, 0, 1, 1,
        1, 1, 0, 0, 0, 0, 1, 1,
        1, 1, 1, 1, 1, 1, 1, 1,
        1, 1, 1, 1, 1, 1, 1, 1
      ]
    }
  }